GLOSSARIUM.                          811

hebbende een alabaster flessche met salve van onvervalsche Nardus van grooten
prijs: ende de flessche gebroken hebbende, goot die op sijn hooft’; Johannes
XII, 3: Maria dan genomen hebbende een pont salve van onvervalschte seer
kostelicke Nardus, heeft de voeten Jesu gesalft.’’

Dr. H. W. Aeckerle (Ec. Jaarboek, Deel XIII, 1927) noemt Spicanardi :

Lavendelkraut, Parfm.

stamet: mogelijk : astim (Perzisch) mouw, laken.

stuck van achten-stucken van acht realen: zie Munten.
sualen: dit woord lijkt een onoplosbare verminking.

subehina: mogelijk: Radix China.

Suffalini: zie Giolphalynen.

Sulfa: zieJuffar.

Sultan: gouverneur.

Sumachia: Shamakhia, hoofdstad der Caucasische provincie Shirwan.
Supercargo: zie percargo.

Suras: Shiraz.

Suria: Syri.                 :

surlen: lees: curlen, zie aldaar.

Suyt: Insulinde.

syde: zie zijde.

Syrvaen: zie Serauw.

T.

tabynen: zijden weefsels.

tactenametten: vermoedelijk: tast-i-nemek (Perzisch)  zoutvat.
taffacilen de Goleonda: zie Cloeden.

taffecielen - taficielen - taffecillen: zie Cleeden.
tamerijn: tamarinden.

Tauris Tabriz.

tehieten: zie Cyet.

ticklemets: zie tactenametten.

tgodsia: zie godia.

tintenago-tintenage -rocktutia: zink, zie Van Dam, uitg. Dr. Stapel.

to(o)ek: tulband.

toetenaggo: zie tintenago.
toffas: Perzisch: tuhfa geschenk.
toma: lees: toman, zie Munten.
tomannen: zie Munten.
travaden: stormen.

trewissa: zie turbits.
troucheman: tolk.

t’siader borael: zie Cleeden.
tufftanen: kwispedoor.
turbits: Perzisch: tarbad Indische wortel, een purgatief.
turkosen: turkooisen.

U.

Usbeyeken: lees: Uzbegs  Turkomannen (zie blz. 742, noot 1).
V.

van een drye: lees: van n, drie 300 4.

van een twee: lees: van n, twee 200 .
varcken  vercken: klein watervat of legger.
